Tile;5,0;1;1;
Tile;6,0;1;2;
Tile;7,0;1;4;
Tile;8,0;1;3;
Tile;9,0;1;5;
Tile;11,10;1;1;
Player;10,5;3;2;
