Tile;4,9;1;7;
Tile;5,9;1;7;
Tile;6,9;1;7;
Tile;6,8;1;7;
Tile;6,7;1;7;
Tile;6,6;1;7;
Tile;6,5;1;7;
Tile;6,4;1;7;
Tile;6,3;1;7;
Tile;3,9;1;7;
Tile;3,8;1;7;
Tile;3,7;1;7;
Tile;3,6;1;7;
Tile;3,5;1;7;
Tile;3,4;1;7;
Tile;3,3;1;7;
Tile;3,2;1;7;
Tile;3,1;1;7;
Tile;3,0;1;7;
Tile;4,0;1;7;
Tile;5,0;1;7;
Tile;6,0;1;7;
Tile;6,3;1;7;
Tile;7,0;1;7;
Tile;7,3;1;7;
Tile;8,0;1;7;
Tile;8,3;1;6;teleportEntity;
Tile;9,0;1;7;
Tile;9,3;1;7;
Tile;10,0;1;7;
Tile;10,3;1;7;
Tile;11,0;1;7;
Tile;11,1;1;7;
Tile;11,2;1;7;
Tile;11,3;1;7;
Player;10,1;3;2;doNothing;playerControl;
NPC;6,1;2;2;doNothing;randomAI;
