Tile;5,0;1;1;
Tile;6,0;2;2;
NotATile;10,0;;1;
Tile;7,0;1;4;
Tile;8,0;2;3;
Tile;9,0;2;5;
Tile;11,10;1;1;
